25
25
#########################
#...#.....#.......#.....#
#.#.#.#.#.#.#.#.#.#.#.#.#
#...#...#...#...#...#...#
#.#########.#.#########.#
#...........0...........#
#.#########.#.#########.#
#...#...#...#...#...#...#
#.#.#.#.#.#.#.#.#.#.#.#.#
#.....#.....#.....#.....#
#...#.....#.......#.....#
0...........0...........0
0.#########.#.#########.0
#...#...#...#...#...#...#
#.#.#.#.#.#.#.#.#.#.#.#.#
#.....#.....#.....#.....#
#.#########.#.#########.#
#...........0...........#
#.#########.#.#########.#
#...#...#...#...#...#...#
#.#.#.#.#.#.#.#.#.#.#.#.#
#.....#.....#.....#.....#
#...#...#...#...#...#...#
#...........0...........#
#########################